9 10 4
1 0 1 1 1 1 0 1 1 1 
1 0 1 0 1 1 1 1 0 1
1 1 1 0 1 1 0 1 1 1
0 0 0 0 1 0 0 0 0 1 
1 1 1 0 1 1 1 0 1 0 
1 0 1 1 1 1 0 1 0 0 
1 0 0 0 0 1 0 0 0 1
1 0 1 1 1 1 0 1 1 1 
1 1 1 0 0 0 1 0 0 1
0 0 3 4
4 6 8 2
0 9 1 6
8 9 8 6
